________E_______________________________
________E_______________________________
________L_______________________________
________L______BBBB__BBBB___BBBBB_______
________L______B__B__B___B__B___________
________L______B__B__B___B__B___________
________L______B__B__B___B__BRRRR_______
________L_H_T__B__B__B___B__B___________
_______EBBBBB__BBBB__BBBB___BBBBB_______
_______E________________________________
_BBBB__EB__B__B____B_B____B_BBBBB_BBBB__
_B___B_EB__B__BB___B_BB___B_B_____B___B_
_B___B_EB__B__B_B__B_B_B__B_BBBBB_B___B_
_BBBB__EB__B__B__B_B_B__B_B_B_____BBBB__
_B___B_EB__B__B___BB_B___BB_B_____B___B_
_B___B_EBBBB__B____B_B____B_BBBBB_B___B_
_______E________________________________
_______E________________________________
_______E________________________________
_______E________________________________
_______E________________________________
_______E________________________________
_______E___________________RRRRRR_______
_______E____________LSSSSSB_____________
_______E____________L___________________
_______E____________L__________SSSSB____
_______E____________L___________________
_______E____________L___________________
_______E____________L___________________
SSSSSSBLBBBBBBBBBBBBBBBBBBBBBBBBBSSSSSSS

