____________________________________L___
____________________________________L___
____________________________________L___
___BB__BB__BBBBB__B___B_____________L___
___BB__BB__B___B__B___B_____________L___
____BBBB___B___B__B___B_____________L___
_____BB____B___B__B___B_____________L___
_____BB____BBBBB__BBBBB_____________L___
____________________________________L___
______BBB__BBBB__BBBBB______________L___
_____B___B_B___B_B__________________L___
_____BBBBB_BBBBB_BBBBB______________L___
_____B___B_B__B__B__________________L___
_____B___B_B___B_BBBBB______________L___
____________________________________L___
__BBBB__BBBBB___BBB___BBBB__________L___
__B___B_B______B___B__B___B_________L___
__B___B_BBBBB__BBBBB__B___B_________L___
__B___B_B______B___B__B___B_________L___
__BBBB__BBBBB__B___B__BBBB__________L___
____________________________________L___
____________________________________L___
____________________________________L___
____________________________________L___
____________________________________L___
____________________________________L___
____________________________________L___
____________________________________L___
__H_________________________________L___
SSSSSSSSSSSSSSSSSSSSSSSSSSSSSSSSSSSSSSSS

