___________________________________E____
___________________________________E____
____T__________G___________________E____
BBSSSBBSSSBBSSSSBLBBBBBBBS_________E____
_________________LRRRRRRRRRRRRR____E____
_________________L_________________E____
_________________L____BBL________T_E____
_________________L____BBL____BBBBBBLBBBB
_________________L____BBL__________L____
_________________L____BBL__________L____
_________________L____BBL______G___L____
___G_____________L____BBL_________TL____
BBBBBBLBBBBBBBBBBB____BBBBBBBBBLBBBBBBBB
______L________________________L________
______L________________________L________
______L________________________L________
______L________________________L________
______L________________________L________
______L____________G___________L________
BBBBBBBBBBBBBBLBBBBBBBBBBBBBBBBL________
______________L________________L________
______________L________________L________
______________LRRRRRRRRRRRRRRRRL________
_________A_T__L________________L__T_____
______LBBBBBBBBB_______________BBBBBBBBL
______L________________________________L
______L________________________________L
______L________________________________L
______L_____________H________G_________L
BBBBBBBBBBBBBBBBBBBBBBBBBBBBBBBBBBBBBBBB