_______________________________________E
_______________________________________E
____T__G_______________________________E
LSSSBSSSL______________________________E
L_______L______________G____T__________E
L_______L_________LBBBBBBBBBBBBBL______E
L_______L_________L_____________L______E
L_T_____L___G_____L_____________L______E
LBSSBBSBL_________L_____________L______E
L_______LRRRRR____L_____________L__T___E
L_______L_________L_____________LBBBBBBE
L__S_S__L_________L_____________L_______
L__S_S__L_________L_____________L_______
L_______LRRRRRRRRRLRRRRRRRRRR___L___G___
LL_____LL_________L_________LBBBSSSSSSSL
L_L___L_L_________L_________L__________L
L__LLL__L_________L_________L__________L
L_______L_________L___T_____L__________L
L_______L_________LBBBBBBBBBB__________L
L___G___L__T___A__L____________________L
SSBBBBSSSSSSBBBSSSL____________________L
SBBBBSSS__________L_______G_____LBBBBLBB
S_____SS__________L_____________L____L__
ST____SS__________L_____RRRRRRRRL____L__
BBBBBBBBBBBBBLBBBBBSSSSSB_______L____L_T
_____________L__________________L___BBBB
_____________L__________________L_______
_____________L__________________L_______
__________H__L__________________L_______
SSSSSSSSSBBBBBBBBBBBBBBBBBBBBBSSSSSSSSSS
